[
	{
		"level": 1,
		"speed": 1,
		"translations": [
			{
				"type": "food",
				"steps": [
					{	"l": "s",		"m": "",		"r":""	},
					{	"l": "",		"m": "",		"r":"s"	},
					{	"l": "",		"m": "",		"r":"s"	},
					{	"l": "s",		"m": "",		"r":""	},
					{	"l": "s",		"m": "",		"r":""	},
					{	"l": "",		"m": "",		"r":"s"	},
					{	"l": "s",		"m": "",		"r":""	},
					{	"l": "",		"m": "",		"r":"s"	}
				]
			},
			{
				"type": "rock",
				"steps": [
					{	"l": "s",		"m": "",		"r":""	},
					{	"l": "",		"m": "",		"r":"s"	},
					{	"l": "s",		"m": "",		"r":""	},
					{	"l": "s",		"m": "",		"r":""	},
					{	"l": "s",		"m": "",		"r":""	},
					{	"l": "",		"m": "",		"r":"s"	},
					{	"l": "",		"m": "",		"r":"s"	},
					{	"l": "s",		"m": "",		"r":""	}
				]
			},
			{
				"type": "food",
				"steps": [
					{	"l": "",		"m": "",		"r":"s"	},
					{	"l": "",		"m": "",		"r":"s"	},
					{	"l": "s",		"m": "",		"r":""	},
					{	"l": "",		"m": "",		"r":"s"	},
					{	"l": "s",		"m": "",		"r":""	},
					{	"l": "s",		"m": "",		"r":""	},
					{	"l": "",		"m": "",		"r":"s"	},
					{	"l": "s",		"m": "",		"r":""	}
				]
			}
			
		]
	},
	{
		"level": 2,
		"speed": 1,
		"translations": [
			{
				"type": "food",
				"steps": [
					{	"l": "s",		"m": "",		"r":""	},
					{	"l": "",		"m": "",		"r":"s"	},
					{	"l": "s",		"m": "",		"r":""	},
					{	"l": "",		"m": "",		"r":"s"	},
					{	"l": "1",		"m": "",		"r":""	},
					{	"l": "2",		"m": "",		"r":""	},
					{	"l": "",		"m": "",		"r":"s"	},
					{	"l": "s",		"m": "",		"r":""	}
				]
			},
			{
				"type": "shark",
				"steps": [
					{	"l": "",		"m": "",		"r":"s"	},
					{	"l": "",		"m": "",		"r":"1"	},
					{	"l": "",		"m": "",		"r":"2"	},
					{	"l": "1",		"m": "",		"r":""	},
					{	"l": "2",		"m": "",		"r":""	},
					{	"l": "",		"m": "",		"r":"s"	},
					{	"l": "s",		"m": "",		"r":""	},
					{	"l": "",		"m": "",		"r":"s"	}
				]
			},
			{
				"type": "food",
				"steps": [
					{	"l": "s",		"m": "",		"r":""	},
					{	"l": "s",		"m": "",		"r":""	},
					{	"l": "",		"m": "",		"r":"s"	},
					{	"l": "",		"m": "",		"r":"1"	},
					{	"l": "",		"m": "",		"r":"2"	},
					{	"l": "1",		"m": "",		"r":""	},
					{	"l": "2",		"m": "",		"r":""	},
					{	"l": "",		"m": "",		"r":"s"	}
				]
			},
			{
				"type": "boat",
				"steps": [
					{	"l": "",		"m": "",		"r":"1"	},
					{	"l": "",		"m": "",		"r":"2"	},
					{	"l": "",		"m": "",		"r":"s"	},
					{	"l": "",		"m": "",		"r":"1"	},
					{	"l": "",		"m": "",		"r":"2"	},
					{	"l": "s",		"m": "",		"r":""	},
					{	"l": "1",		"m": "",		"r":""	},
					{	"l": "2",		"m": "",		"r":""	}
				]
			}
		]
	},
	{
		"level": 3,
		"speed": 1,
		"translations": [
			{
				"type": "rock",
				"steps": [
					{	"l": "",		"m": "1",		"r":""	},
					{	"l": "",		"m": "2",		"r":""	},
					{	"l": "s",		"m": "",		"r":""	},
					{	"l": "1",		"m": "",		"r":""	},
					{	"l": "2",		"m": "",		"r":""	},
					{	"l": "s",		"m": "",		"r":""	},
					{	"l": "",		"m": "s",		"r":""	},
					{	"l": "s",		"m": "",		"r":""	},
					{	"l": "",		"m": "",		"r":"1"	},
					{	"l": "",		"m": "",		"r":"2"	},
					{	"l": "",		"m": "",		"r":"s"	},
					{	"l": "",		"m": "s",		"r":""	}
				]
			},
			{
				"type": "food",
				"steps": [
					{	"l": "",		"m": "s",		"r":""	},
					{	"l": "s",		"m": "",		"r":""	},
					{	"l": "",		"m": "",		"r":"s"	},
					{	"l": "",		"m": "1",		"r":""	},
					{	"l": "",		"m": "2",		"r":""	},
					{	"l": "s",		"m": "",		"r":""	},
					{	"l": "",		"m": "",		"r":"s"	},
					{	"l": "",		"m": "",		"r":"1"	},
					{	"l": "",		"m": "",		"r":"2"	},
					{	"l": "",		"m": "1",		"r":""	},
					{	"l": "",		"m": "2",		"r":""	},
					{	"l": "s",		"m": "",		"r":""	}
				]
			},
			{
				"type": "shark",
				"steps": [
					{	"l": "",		"m": "",		"r":"s"	},
					{	"l": "",		"m": "s",		"r":""	},
					{	"l": "",		"m": "",		"r":"1"	},
					{	"l": "",		"m": "",		"r":"2"	},
					{	"l": "",		"m": "1",		"r":""	},
					{	"l": "",		"m": "2",		"r":""	},
					{	"l": "",		"m": "1",		"r":""	},
					{	"l": "",		"m": "2",		"r":""	},
					{	"l": "s",		"m": "",		"r":""	},
					{	"l": "1",		"m": "",		"r":""	},
					{	"l": "2",		"m": "",		"r":""	},
					{	"l": "",		"m": "s",		"r":""	}
				]
			},
			{
				"type": "food",
				"steps": [
					{	"l": "1",		"m": "",		"r":""	},
					{	"l": "2",		"m": "",		"r":""	},
					{	"l": "s",		"m": "",		"r":""	},
					{	"l": "",		"m": "",		"r":"s"	},
					{	"l": "",		"m": "1",		"r":""	},
					{	"l": "",		"m": "2",		"r":""	},
					{	"l": "",		"m": "",		"r":"s"	},
					{	"l": "",		"m": "",		"r":"1"	},
					{	"l": "",		"m": "",		"r":"2"	},
					{	"l": "",		"m": "s",		"r":""	},
					{	"l": "",		"m": "",		"r":"s"	},
					{	"l": "s",		"m": "",		"r":""	}
				]
			}
		]
	},
	{
		"level": 4,
		"speed": 1.5,
		"translations": [
			{
				"type": "boat",
				"steps": [
					{	"l": "s",		"m": "",		"r":""	},
					{	"l": "",		"m": "s",		"r":""	},
					{	"l": "",		"m": "",		"r":"s"	},
					{	"l": "",		"m": "s",		"r":""	},
					{	"l": "",		"m": "s",		"r":""	},
					{	"l": "s",		"m": "",		"r":"s"	},
					{	"l": "s",		"m": "",		"r":""	},
					{	"l": "1",		"m": "",		"r":""	},
					{	"l": "2",		"m": "",		"r":""	},
					{	"l": "",		"m": "s",		"r":""	},
					{	"l": "",		"m": "",		"r":"1"	},
					{	"l": "",		"m": "",		"r":"2"	}
				]
			},
			{
				"type": "rock",
				"steps": [
					{	"l": "",		"m": "",		"r":"s"	},
					{	"l": "",		"m": "1",		"r":""	},
					{	"l": "",		"m": "2",		"r":""	},
					{	"l": "s",		"m": "",		"r":""	},
					{	"l": "s",		"m": "",		"r":""	},
					{	"l": "s",		"m": "s",		"r":""	},
					{	"l": "s",		"m": "",		"r":"s"	},
					{	"l": "",		"m": "s",		"r":""	},
					{	"l": "",		"m": "",		"r":"1"	},
					{	"l": "",		"m": "",		"r":"2"	},
					{	"l": "",		"m": "s",		"r":"s"	},
					{	"l": "s",		"m": "",		"r":""	}
				]
			},
			{
				"type": "food",
				"steps": [
					{	"l": "s",		"m": "",		"r":""	},
					{	"l": "",		"m": "1",		"r":""	},
					{	"l": "",		"m": "2",		"r":""	},
					{	"l": "s",		"m": "1",		"r":""	},
					{	"l": "",		"m": "2",		"r":""	},
					{	"l": "",		"m": "",		"r":"s"	},
					{	"l": "s",		"m": "",		"r":"s"	},
					{	"l": "",		"m": "s",		"r":""	},
					{	"l": "s",		"m": "s",		"r":""	},
					{	"l": "",		"m": "",		"r":"s"	},
					{	"l": "",		"m": "s",		"r":"s"	},
					{	"l": "s",		"m": "s",		"r":""	}
				]
			},
			{
				"type": "shark",
				"steps": [
					{	"l": "1",		"m": "",		"r":""	},
					{	"l": "2",		"m": "",		"r":""	},
					{	"l": "s",		"m": "",		"r":""	},
					{	"l": "",		"m": "s",		"r":""	},
					{	"l": "",		"m": "s",		"r":"s"	},
					{	"l": "s",		"m": "",		"r":"s"	},
					{	"l": "1",		"m": "",		"r":""	},
					{	"l": "2",		"m": "",		"r":""	},
					{	"l": "",		"m": "s",		"r":""	},
					{	"l": "",		"m": "",		"r":"1"	},
					{	"l": "",		"m": "",		"r":"2"	},
					{	"l": "s",		"m": "",		"r":"s"	}
				]
			}
		]
	},
	{
		"level": 5,
		"speed": 2,
		"translations": [
			{
				"type": "rock",
				"steps": [
					{	"l": "s",		"m": "",		"r":""	},
					{	"l": "",		"m": "",		"r":"s"	},
					{	"l": "",		"m": "1",		"r":""	},
					{	"l": "",		"m": "2",		"r":""	},
					{	"l": "",		"m": "",		"r":"s"	},
					{	"l": "s",		"m": "s",		"r":""	},
					{	"l": "1",		"m": "",		"r":""	},
					{	"l": "2",		"m": "",		"r":""	},
					{	"l": "",		"m": "s",		"r":""	},
					{	"l": "",		"m": "s",		"r":""	},
					{	"l": "s",		"m": "",		"r":""	},
					{	"l": "",		"m": "",		"r":"s"	},
					{	"l": "s",		"m": "s",		"r":""	},
					{	"l": "",		"m": "1",		"r":""	},
					{	"l": "",		"m": "2",		"r":""	},
					{	"l": "",		"m": "",		"r":"s"	}
				]
			},
			{
				"type": "shark",
				"steps": [
					{	"l": "1",		"m": "",		"r":""	},
					{	"l": "2",		"m": "",		"r":""	},
					{	"l": "",		"m": "s",		"r":""	},
					{	"l": "s",		"m": "",		"r":""	},
					{	"l": "s",		"m": "",		"r":""	},
					{	"l": "",		"m": "1",		"r":""	},
					{	"l": "",		"m": "2",		"r":""	},
					{	"l": "",		"m": "s",		"r":"s"	},
					{	"l": "s",		"m": "",		"r":"s"	},
					{	"l": "s",		"m": "",		"r":""	},
					{	"l": "",		"m": "",		"r":"s"	},
					{	"l": "1",		"m": "",		"r":""	},
					{	"l": "2",		"m": "",		"r":""	},
					{	"l": "",		"m": "s",		"r":"s"	},
					{	"l": "",		"m": "s",		"r":""	},
					{	"l": "s",		"m": "",		"r":"s"	}
				]
			},
			{
				"type": "boat",
				"steps": [
					{	"l": "s",		"m": "",		"r":"s"	},
					{	"l": "",		"m": "s",		"r":""	},
					{	"l": "1",		"m": "",		"r":""	},
					{	"l": "2",		"m": "",		"r":""	},
					{	"l": "",		"m": "s",		"r":""	},
					{	"l": "s",		"m": "",		"r":"s"	},
					{	"l": "1",		"m": "",		"r":""	},
					{	"l": "2",		"m": "",		"r":""	},
					{	"l": "",		"m": "1",		"r":""	},
					{	"l": "",		"m": "2",		"r":""	},
					{	"l": "s",		"m": "s",		"r":""	},
					{	"l": "",		"m": "1",		"r":""	},
					{	"l": "",		"m": "2",		"r":""	},
					{	"l": "",		"m": "",		"r":"s"	},
					{	"l": "",		"m": "",		"r":"s"	},
					{	"l": "s",		"m": "s",		"r":""	}
				]
			},
			{
				"type": "food",
				"steps": [
					{	"l": "s",		"m": "",		"r":""	},
					{	"l": "",		"m": "s",		"r":""	},
					{	"l": "s",		"m": "",		"r":""	},
					{	"l": "",		"m": "1",		"r":"s"	},
					{	"l": "",		"m": "2",		"r":""	},
					{	"l": "s",		"m": "1",		"r":""	},
					{	"l": "",		"m": "2",		"r":""	},
					{	"l": "s",		"m": "",		"r":""	},
					{	"l": "",		"m": "1",		"r":""	},
					{	"l": "",		"m": "2",		"r":""	},
					{	"l": "",		"m": "",		"r":"s"	},
					{	"l": "s",		"m": "s",		"r":""	},
					{	"l": "",		"m": "",		"r":"s"	},
					{	"l": "s",		"m": "s",		"r":""	},
					{	"l": "",		"m": "",		"r":"1"	},
					{	"l": "",		"m": "",		"r":"2"	}
				]
			},
			{
				"type": "rock",
				"steps": [
					{	"l": "",		"m": "s",		"r":""	},
					{	"l": "s",		"m": "",		"r":""	},
					{	"l": "",		"m": "",		"r":"s"	},
					{	"l": "",		"m": "",		"r":"1"	},
					{	"l": "",		"m": "",		"r":"2"	},
					{	"l": "s",		"m": "s",		"r":""	},
					{	"l": "",		"m": "",		"r":"s"	},
					{	"l": "",		"m": "1",		"r":""	},
					{	"l": "",		"m": "2",		"r":""	},
					{	"l": "s",		"m": "",		"r":"1"	},
					{	"l": "",		"m": "",		"r":"2"	},
					{	"l": "1",		"m": "",		"r":""	},
					{	"l": "2",		"m": "",		"r":""	},
					{	"l": "",		"m": "s",		"r":""	},
					{	"l": "",		"m": "",		"r":"s"	},
					{	"l": "s",		"m": "s",		"r":""	}
				]
			}
		]
	}
]